NO ./textures/solid-rock-wall.xpm
SO ./textures/stone-brick-wall.xpm
WE ./textures/mossy-brick-wall.xpm
EA ./textures/Rocky_Wall.xpm

F 58,58,58
C 255,156,51

	11111111111111
11111100000001
10001100011001
10000000011001
10000000000001
100000N0000001
10000000000001
11111111111111