NO /home/khuk/42Vienna/cub3D/textures/wall_1.xpm
SO /home/khuk/42Vienna/cub3D/textures/wall_2.xpm
WE /home/khuk/42Vienna/cub3D/textures/wall_3.xpm
EA /home/khuk/42Vienna/cub3D/textures/wall_4.xpm

F 220,100,0
C 225,30, 0

     1111111111
    100000000001
   10000000000001
   100000000N0001
    100000000001
     1100000011
       100001
        1001
         11    
     