NO ./textures/wall_5.xpm
SO ./textures/wall_6.xpm
WE ./textures/wall_7.xpm
EA ./textures/wall_9.xpm

F 120, 145,7
C 20, 190, 217

11111111111111
10000000000001
10000000011001
10000000000001
10000000000001
100000N0000001
10000000000001
11111111111111