SO ./textures/wall_2.xpm
NO ./textures/wall_1.xpm
EA ./textures/wall_7.xpm
WE ./textures/wall_3.xpm

F 184,113,39
C 51,198,227

         111111111  111111111111111111
         100000001  100000000000000001
         10110000111100000001111111111
11111111110000000000000000011111
10000000111100010000000001001
10000000000000110101110000001
10000000111110000001 10100001
111111111  111111111 11111001    
1111 111111111111111111111001
1111 1000000000000000000000N1
1111 111111111111111111111111
