NO /home/khuk/42Vienna/cub3D/textures/wall_1.xpm
SO /home/khuk/42Vienna/cub3D/textures/wall_2.xpm
WE /home/khuk/42Vienna/cub3D/textures/wall_3.xpm
EA /home/khuk/42Vienna/cub3D/textures/wall_4.xpm

F 220,100,0
C 225,30, 0

11111111111111
1N000000000001
10000000000001
10000000000001
10000000000001
10000000000001
10000000000001
11111111111111