NO ./textures/mossy-brick-wall.xpm
SO ./textures/Dark_Grey.xpm
WE ./textures/stone-brick-wall.xpm
EA ./textures/planks_oak.xpm

F 245, 188, 188
C 245, 242, 188

11111111111111
1N000000000001
10000000000001
10000000000001
10000000000001
10000000000001
10000000000001
11111111111111