NO /home/khuk/cub3D/textures/mossy-brick-wall.xpm
SO /home/khuk/cub3D/textures/sky.xpm
WE /home/khuk/cub3D/textures/wall_3.xpm
EA /home/khuk/cub3D/textures/stone-brick-wall.xpm

F 58,58,58
C 137, 207, 239

11111111111111
10001100000001
10001100011001
10000000011001
10000000000001
100000N0000001
10000000000001
11111111111111